{
    "-1": [
        [  0,  0,  0,  0,  0,  0,  0,  0,  0,  0,  0 ],
        [  0,  0,  0,  0,  0,  0,  0,  0,  0,  0,  0 ],
        [  0,  0,  0,  0,  0,  0,  0,  0,  0,  0,  0 ],
        [  0,  0,  0,  0,  0,  0,  0,  0,  0,  0,  0 ],
        [  0,  0,  0,  0,  0,  0,  0,  0,  0,  0,  0 ],
        [  0,  0,  0,  0,  0,  0,  0,  0,  0,  0,  0 ],
        [  0,  0,  0,  0,  0,  0,  0,  0,  0,  0,  0 ],
        [  0,  0,  0,  0,  0,  0,  0,  0,  0,  0,  0 ],
        [  0,  0,  0,  0,  0,  0,  0,  0,  0,  0,  0 ],
        [  0,  0,  0,  0,  0,  0,  0,  0,  0,  0,  0 ],
        [  0,  0,  0,  0,  0,  0,  0,  0,  0,  0,  0 ]
    ],
    "1": [
        [  0,  0,  0,  0,  0,  0, 10,  0,  0,  0,  0 ],
        [  0,  0,  0,  0,  0,  0, 10,  0,  0,  0,  0 ],
        [  0,  0,  0,  0,  0,  0, 10,  0,  0,  0,  0 ],
        [  0,  0,  0, 10, 12, 12, 12,  0,  0,  0,  20],
        [  0,  0,  0, 10,  0,  0,  0,  0,  0,  0,  0 ],
        [  0,  0,  0, 10,  0,  0,  0,  0,  0,  0,  0 ],
        [ 12, 12, 12, 12, 11,  0,  0,  0,  0,  0,  0 ],
        [  0,  0,  0,  0, 12, 12, 12, 22, 12, 12, 12 ],
        [  0,  0,  0,  0,  0,  0,  0,  0,  0,  0,  0 ],
        [  0,  0,  0,  0,  0,  0,  0,  0,  0,  0,  20],
        [  0,  0,  0,  0,  0,  0,  0,  0,  0,  0,  0 ]
    ],
    "3": [
        [  0,  0,  0,  0,  0,  10,  0,  0,  0,  0,  0 ],
        [  0,  0,  0,  0,  0,  10,  0,  0,  0,  0,  0 ],
        [  0,  0,  0,  0,  0,  10,  0,  0,  0,  0,  0 ],
        [  0,  0,  0,  0,  0,  10,  0,  0,  0,  0,  0 ],
        [  0,  0,  0,  0,  0,  10, 13, 13, 13, 13, 13 ],
        [  0,  0,  0,  0,  0,  10,  0,  0,  0,  0,  0 ],
        [  0,  0,  0,  0,  0,  10,  0,  0,  0,  0,  0 ],
        [ 12, 12, 12, 12, 12,  12, 11,  0,  0,  0,  0 ],
        [  0,  0,  0,  0,  0,  10,  0,  0,  0,  0,  0 ],
        [  0,  0,  0,  0,  0,  10,  0,  0,  0,  0,  0 ],
        [  0,  0,  0,  0,  0,  10,  0,  0,  0,  0,  0 ]
    ],


    "lvl1": [
        [  0,  0,  0,  0,  0,  0, 10,  0,  0,  0,  10,  0,  0,  0,  0,  0,  10,  0,  0,  0,  0,  0 ],
        [  0,  0,  0,  0,  0,  0, 10,  0,  0,  0,  10,  0,  0,  0,  0,  0,  10,  0,  0,  0,  0,  0 ],
        [  0,  0,  0,  0,  0,  0, 10,  0,  0,  0,  10,  0,  0,  0,  0,  0,  10,  0,  0,  0,  0,  0 ],
        [  0,  0,  0, 10, 12, 12, 12,  0,  0,  0,  20,  0,  0,  0,  0,  0,  10,  0,  0,  0,  0,  0 ],
        [  0,  0,  0, 10,  0,  0,  0,  0,  0,  0,  10,  0,  0,  0,  0,  0,  10, 13, 13, 13, 23, 13 ],
        [  0,  0,  0, 10,  0,  0,  0,  0,  0,  0,  10,  0,  0,  0,  0,  0,  10,  0,  0,  0,  0,  0 ],
        [ 12, 12, 12, 12, 11, 13, 13, 13, 13, 13,  10, 13, 13, 13, 13, 13,  10,  0,  0,  0,  0,  0 ],
        [  0,  0,  0,  0, 12,  0,  0, 22,  0,  0,  12, 11,  0,  0,  0,  0,  12, 11,  0,  0,  0,  0 ],
        [  0,  0,  0,  0,  0,  0,  0,  0,  0,  0,  20,  0,  0,  0,  0,  0,  20,  0,  0,  0,  0,  0 ],
        [  0,  0,  0,  0,  0,  0,  0,  0,  0,  0,  10,  0,  0,  0,  0,  0,  10,  0,  0,  0,  0,  0 ],
        [  0,  0,  0,  0,  0,  0,  0,  0,  0,  0,  10,  0,  0,  0,  0,  0,  10,  0,  0,  0,  0,  0 ] 
    ],
    
    "lvl1RoomMap": [
        [  0,  0,  0,  0,  0,  0,  0,  6,  6,  6,  6,  4,  4,  4,  4,  4,  4,  1,  1,  1,  1,  1 ],
        [  0,  0,  0,  0,  0,  0,  0,  6,  6,  6,  6,  4,  4,  4,  4,  4,  4,  1,  1,  1,  1,  1 ],
        [  0,  0,  0,  0,  0,  0,  0,  6,  6,  6,  6,  4,  4,  4,  4,  4,  4,  1,  1,  1,  1,  1 ],
        [  0,  0,  0,  0,  0,  0,  0,  6,  6,  6,  6,  4,  4,  4,  4,  4,  4,  1,  1,  1,  1,  1 ],
        [  0,  0,  0,  6,  6,  6,  6,  6,  6,  6,  6,  4,  4,  4,  4,  4,  4,  1,  1,  1,  1,  1 ],
        [  0,  0,  0,  6,  6,  6,  6,  6,  6,  6,  6,  4,  4,  4,  4,  4,  4,  2,  2,  2,  2,  2 ],
        [  0,  0,  0,  6,  6,  6,  6,  6,  6,  6,  6,  4,  4,  4,  4,  4,  4,  2,  2,  2,  2,  2 ],
        [  5,  5,  5,  5,  5,  5,  5,  5,  5,  5,  5,  3,  3,  3,  3,  3,  3,  2,  2,  2,  2,  2 ],
        [  5,  5,  5,  5,  5,  5,  5,  5,  5,  5,  5,  3,  3,  3,  3,  3,  3,  2,  2,  2,  2,  2 ],
        [  5,  5,  5,  5,  5,  5,  5,  5,  5,  5,  5,  3,  3,  3,  3,  3,  3,  2,  2,  2,  2,  2 ],
        [  5,  5,  5,  5,  5,  5,  5,  5,  5,  5,  5,  3,  3,  3,  3,  3,  3,  2,  2,  2,  2,  2 ] 
    ]


}
